#######################################
# Syntax Coloring Map For ExampleLibrary
#######################################

#######################################
# Datatypes (KEYWORD1)
#######################################

SharedData	KEYWORD1
Hexapod	KEYWORD1
Color	KEYWORD1
userPresetInputData	KEYWORD1
MovementData	KEYWORD1
PoseData	KEYWORD1
LedData	KEYWORD1

#######################################
# Methods and Functions (KEYWORD2)
#######################################

move	KEYWORD2

#######################################
# Instances (KEYWORD2)
#######################################

linearVelocity	KEYWORD2
direction	KEYWORD2
angularVelocity	KEYWORD2

translationX	KEYWORD2
translationY	KEYWORD2
translationZ	KEYWORD2
rotationX	KEYWORD2
rotationY	KEYWORD2
rotationZ	KEYWORD2
poseSpeed	KEYWORD2

ledPrimarClr	KEYWORD2
ledSecondarClr	KEYWORD2
ledDiretion	KEYWORD2
ledSpreadRatio	KEYWORD2
ledRotationSpeed	KEYWORD2
ledBlinkingSpeed	KEYWORD2
ledManualClr	KEYWORD2
ledMode	KEYWORD2
moveDuration	KEYWORD2
gaitID	KEYWORD2
stepHeight	KEYWORD2
servoPower	KEYWORD2

setLed	KEYWORD2
setLedRotationSpeed	KEYWORD2
setLedBlinkingSpeed	KEYWORD2
setLedStatic	KEYWORD2
move	KEYWORD2
rotate	KEYWORD2
tilt	KEYWORD2
stretch	KEYWORD2
setHeight	KEYWORD2
getTouchPattern	KEYWORD2
getBatteryVoltage	KEYWORD2
getBatteryPercentage	KEYWORD2
setMode	KEYWORD2
getMode	KEYWORD2
enterUserMode	KEYWORD2
exitUserMode	KEYWORD2

#######################################
# Constants (LITERAL1)
#######################################

HEXAPOD_VERSION_MAJOR	LITERAL1
HEXAPOD_VERSION_MINOR	LITERAL1
HEXAPOD_VERSION_PATCH	LITERAL1


LED_COUNT	LITERAL1
LED_PIN	LITERAL1
SERVO_POWER_PIN	LITERAL1

TASK_PERIOD_WALK	LITERAL1
TASK_PERIOD_LED	LITERAL1
TASK_PERIOD_BT	LITERAL1
TASK_PERIOD_TOUCH	LITERAL1
TASK_PERIOD_SERVO	LITERAL1
TASK_PERIOD_ROBOT	LITERAL1
TASK_PERIOD_BATT	LITERAL1
TASK_PERIOD_DANCE	LITERAL1

MOVE_DURATION_DEFAULT	LITERAL1

SERVO_WALKING_MODE	LITERAL1
SERVO_CALIBRATION_MODE	LITERAL1
ROBOT_BATTERY_EMPTY_MODE_VOLTAGE_TRESHOLD	LITERAL1

ROBOT_USER_MODE	LITERAL1
ROBOT_STANDBY_MODE	LITERAL1
ROBOT_WALK_MODE	LITERAL1
ROBOT_DANCE_MODE	LITERAL1
ROBOT_SETUP_MODE	LITERAL1
ROBOT_CALIBRATION_MODE	LITERAL1
ROBOT_BATTERY_EMPTY_MODE	LITERAL1

LED_MANUAL_MODE	LITERAL1
LED_PARAMETRIC_MODE	LITERAL1
LED_CUSTOM_MODE	LITERAL1

BATTERY_EMPTY_STATE	LITERAL1
BATTERY_LOW_STATE	LITERAL1
BATTERY_MID_STATE	LITERAL1
BATTERY_HIGH_STATE	LITERAL1

MIN_TURN_ON_VOLTAGE	LITERAL1

LED_R1	LITERAL1
LED_R2	LITERAL1
LED_R3	LITERAL1
LED_L1	LITERAL1
LED_L2	LITERAL1
LED_L3	LITERAL1

LED_R1_ANGLE	LITERAL1
LED_R2_ANGLE	LITERAL1
LED_R3_ANGLE	LITERAL1
LED_L1_ANGLE	LITERAL1
LED_L2_ANGLE	LITERAL1
LED_L3_ANGLE	LITERAL1

MOVE_SPEED	LITERAL1
TURN_SPEED	LITERAL1
TILT_AMMOUNT	LITERAL1
STRETCH_AMMOUNT	LITERAL1

TOUCH_000	LITERAL1
TOUCH_X00	LITERAL1
TOUCH_0X0	LITERAL1
TOUCH_XX0	LITERAL1
TOUCH_00X	LITERAL1
TOUCH_X0X	LITERAL1
TOUCH_0XX	LITERAL1
TOUCH_XXX	LITERAL1

RED	LITERAL1
GREEN	LITERAL1
BLUE	LITERAL1
YELLOW	LITERAL1
PURPLE	LITERAL1
CYAN	LITERAL1
WHITE	LITERAL1
ORANGE	LITERAL1
BLACK	LITERAL1

FORWARD	LITERAL1
BACKWARD	LITERAL1
LEFT	LITERAL1
RIGHT	LITERAL1
STOP	LITERAL1
